original_response	predicted_response
32 year old midfielder cheikh n'doye	unk
will senegal win the african nations \?	david ospina is the captain
who is senegal 's coach \?	i think they will be a good team
do senegal have many players in europe \?	the captain is the captain of the captain is the
yes , a lot of their squad members play club	i think they are the best player \?
yes , nigeria made it to the world cup this	they have won the world cup
nigeria did not win the world cup , the lost	i think they have won the world cup
i really liked it , the colors went well together	i think he is a good team
nigeria 's main color is green	white and white
john obi mikel might be the best player	i think the best player is the best player is
i have n't , personally , played any games this	i think they have a good team
psg has too big of a media presence to not	i think they have a good team
what makes them such a great team \?	i think that it is a good team
if neymar leaves paris sg , he would probably end	he 's a great team
surely everybody has their price \?	i think they will be more players
yes , with the heart they showed in 2018 ,	i think they will be a good team
i agree , iceland is always an underdog and it	i think they will be a good team
will iceland qualify for the euro \?	i think they will be a good team
if they unk it	i think they will be a good team
what is unk for iceland	i think they are playing n't
nigeria is a very well performing team and i like	i think that \?
jon obi mikkel	i think it is the best player
when was nigeria in the world cup last \?	i think they will be a good team
how did they do in their last world cup appearance	i think they have won the world cup
probably the best in recent history	i think they are a good team \?
like , a billion 	the most goals is the best player in the world
what about chelsea \?	i think they have been a good players
i do not think so because manchester city is very	yes , i think they will be a good team
maurizio sarri	unk is the captain
no , they are not 	yes , i think they have a good team 
they have a very white uniform	i think that porto is black and white and white
they have a very white uniform and they have a	they have a good team
their home stadium is called the bernabeu	the colors is black and white
the real madrid stadium can hold 80 , 000 people	unk
unk	they have a good team
ballspielverein borussia 09 e v dortmund	unk
yes it is , of course 	unk
only 11 of the 29 players in dortmund 's first	i think he is a good player on the best
unk , bvb dortmund represent many nations and unk 	i think they are the best player
yes , his best player is marco reus 	i think paco alcacer is the best player
i dont care for any south american teams	i agree , they are a good team 
yes , if i like soccer 	yes , they have a good team 
portugal plays in europe not south america	i think so they are a good team
rui patricio	diego simeone
rui patricio is 30 years old	i think it is the best player
me too	i think they are a good team
they have many talented players	the best player is the best player is the best
juventus has the best defense in the world	they are a good team
what about senegal makes you like them \?	i like them
yes and i like your player mane	i think that is the best player on the world
me too	i think he is a good team
unk is a good player	i think that he is a good team
keita balde diao	i think it is the best player
yeah me too	i think they are a good team
the best player in senegal is unk diouf	i think it is the best player
no , they have never won any 	yes , they have won the world cup 
aliou cisse is the coach	jose mourinho is the captain
they are placed 23 unk	i think it is the best player
witsel played all but one of belgium 's 2018 world	yes , they have won the world cup 
yes they have won it a few times	i think they have won the world cup
little , a little , few and a few 	i think they will be a good team
please repeat the question	i think they have a good team
they have very talent players and they ca n't put	what is the best player \?
africa	very good team
they are one of the best sides in africa	they have a good team
what does senegal mean \?	i think that was founded in the world cup
i think senegal is known as part of africa	i think that is a good team \?
senegal has a chance to be the winner for the	i think they will be a good team
they are one of the better european sides	i like them
yes the is playing	i think that how long is the best player on
messi will be leaving barcelona soon	i think it is the best player
barcelona is red and yellow	white and white
it called camp nou and is the largest stadium in	the captain is the captain of the team is the
nigeria came in second place	the world cup in the world cup
liverpool won	the best player was the best
nigeria just ca n't catch a break	what was the world cup
nigeria you can not play against liverpool because nigeria is	i think they are the best player \?
possibly , nigeria is a great team 	i think they will be a good team
fc bayern plays in the allianz arena	the unk
75 , 000 people 	the unk
i think they might be the unk	i think they are the best player \?
the bayern munich captain is philipp unk	unk is the captain of the captain
he is not yet the captain	i think he is a good player
i like colombia , go falcao ! 	i like them
if i like colombia and i want to see falcao	i think they will be a good team
jose pekerman	diego simeone
i highly doubt that they can do better next time	i think they are a good team
yes of course i also think the same can be	i think that was founded \?
no , france plays too much of a unk game	i think that it is a good team
they won the championship , so maybe they should keep	i think they 're a good players
yes , france plays too well to unk everything 	i think they have a good team
in my opinion , 4 8 	they have a good team
will unk move to real madrid \?	i think they will be a good team
they are fun to watch and i'm very unk to	i think they are a good team
yes , i totally agree that france deserved to win	i think they will be a good team
there were n't really any other teams that unk as	i think they have won the world cup
they must have a very good chance , but four	yes , they have a good team 
more unk will certainly help and their balls unk skills	i think they will be a good team
estadio do dragao	the best player is the best player is the best
unk martinez	unk is the captain
he scored atleast 3	he scored 5 goals
i think colombia	i think they are the best team
in 2003 2004 when they won cl	yes , i think they have a good team 
uruguay are good but i do n't like unk	i think they are a good team
but you cannot say that suarez is not talented	i think they are a good team
cavani	i think that is a good team
yes it should be rather easy path to qualifications	i think they will be a good team
this is not a question that can be answered	i think they will be a good players
i think they will	yes , i think they will be a good team
i think that they have a great future ahead of	i think they are a good team
santiago unk is the new coach	unk is the captain
florentino perez is the manager	diego simeone
santiago bernabeu is the name of their stadium	unk is the captain
no , senegal has never won a world cup 	i think they have won the world cup
senegal needs to improve	i think they have won the world cup
senegal	i think it is a good team
the senegal players have unk , we need to watch	yes , they have won the world cup 
have no idea	thomas tuchel
yes !	i think the most age is a new team \?
yes , he is a goal keeper 	i think he is a good player
how many saves has he made \?	i think he is the best player
most of croatia 's players are excellent !	i think he is a good team
about 29	he has scored 5 goals
lionel messi	unk is the best player
i am going to say messi	i think it is the best player
blue and red with which the	white and white
he does n't play badly it is just that international	he is a good player
ca n't agree more !	i think they are a good team
always the porto is a team to beat	yes , they have a good team 
i agree , the porto has a rival team and	i think they have a good team
yes they will	yes , they have a good team 
yes , they are supported by their home fans they	they are a good team
not good enough that was expected	i think they did
that depends on which league players participate	i think they have a good team
isco	i think they are a good team
my favorite defender is sergio ramos , but puyol is	unk is the best player on the best player on
i think pique is better than sergio ramos and puyol	i think he is a good team
only if you want to lose !	i do n't think they are a good team
unk	they have a good players
they have a very good chance seeing as they won	i think they will be a good team
france have great superior strategies	i think that is a good team
giroud will be the most prominent striker	i think their current coach will be the coach
they should change their coach	i think they are a good team
he did n't do a good job in the last	i think he is a good player
the coach did n't prepare his team well enough	they are a good team
germany lacked basic skills this was the issue they over	i think they have a good team
stopping the other team from scoring	they are a good players
portugal 's biggest loss was 10 0 to england may	i think they have a good team
no , portugal has improved and i'm sure they will	i think it is a good team
is unk unk unk a player for portugal \?	i think they will be a good team
i do n't know do you think it 's cristiano	i think they are a good team
no it wasnt , he wasnt alive when they lost	i think they are the best player \?
they are great fun to watch and have some great	i think they have a good team
it is a shame , feel this was their time	i think they will be more players to see them
hannes halldorsson was the best in my opinion not many	i think he will be a good player
yes	i think they will be a good team
i bet they make it out of the group stage	i think they will be able to be able to
i believe their record was 3 3 7 been nice	the last time cup in the world cup 2018
i think that they are over rated	i think that is the best player \? they are
they have n't won the league since 2013 they 're	yes , i think they have a good players 
manchester unk has a strong following who does n't t	i think that is a good team
i believe they will stay loyal they may turn on	yes , he is a good team 
jose mourinho is the coach	jose mourinho is the captain
uruguay is in south america	i think it is the best player in the world
no , oscar tabarez is still their coach 	i think they are the best player on the best
a3 he is doing well so far	i think he is a good team
yes uruguay seems happy with unk as their coach	i think that they will be a good team
they are not as good as mexico , brazil and	i think they will be a good players
porto need to spend more money	i think they are the best player \?
i love the team fc porto	i think they are a good team
fc porto is good , but not the best 	i think it is a good team
well , they 're currently first in the league 	i think they will be a good team
iker casillas unk	i think it is the best player
sadio mane	i think it is the best player
i thought they were a unk african football has so	i think they will be a good team
they are a better club not by a lot but	i think they have a good team
senegal jersey is green	they play in the red
honestly there captain is definitely there best player in my	i think it is the best player
what native american language was super unk unk the first	i think they are the best player \?
cristiano unk and juventus are still favored	yes , i think they will be a good team
juventus will be really good this season	i think so he is a good team
now that ronaldo has joined them	i think they will be a good team
last season 20 12	they have a good team
i was sad to see them lose to sweden this	i like them
no , i do n't think they could have won	i think they have a good team
i think they need to work on their tactical and	i think they will be a good team
switzerland has now been to the finals , so yes	i think they will be a good team
stephan lichtsteiner is their new captain	i think ronaldo is the current coach of the captain
great german side	i think it is the best player \?
fc bayern munich unk	unk
february 27 , 1900 	i think the best player is the best player on
unk unk	david ospina is the captain
what was the team 's overall score this season \?	unk
milan look good this year	i think they have a good team
yes , they are a top team 	they have a good team
unk	i think they are a good team
black and red	black and white
san siro stadium	the team is not good
best team in the uk	i think they are a good team
unk then there 4 5 record last year , i	i think they will be a good team
no , but they will be up there in rank	i think they will be a good team
perhaps they lack some overall depth	i think they will be a good players
antoine griezmann	i think they will be a good players
do n't know	the captain is the captain
yes , oscar tabarez is uruguay 's head coach 	i think it is a good team
their unk are good , but it should be a	he is a good coach
unk blue and black	they play in the red
yes , those are the colors 	they are red
france	i think they have been a good times
impressive victory	i think they have won the world cup
i do n't see why not	i think they will be a good team
gylfi sigurdsson	the captain was the captain of the captain
france it 's a very good team to play	they are a good team
64 goals	they have won the world cup
pierre emerick aubameyang	the best player was the best player
no , because they are a club team 	i think they will be a good team
the best goal was the one that scored aubameyang	the best player is the best player \?
roman burki was the starting goalie	thomas tuchel
a question for the unk	i think the best player is the best player \?
on wednesday , august 15 , i think it 's	the best player is the best player
real madrid will play atletico madrid for a cup on	i think they have a good team
if they had	yes , they have a good players 
who does real madrid play after they play atletico madrid	i think it is the best player
who is your favorite player \?	i think that it is a good team
my favorite team is everton	i think that it is a good team
chelsea is better than everton	i think they are a good team
this is not a question but i agree to that	i think they will be a good team
1905	the best player was founded in the world cup in
just once	i think it was the world cup
only one time	i do n't think they have a good team
iceland could qualify at any time	do you think he is a good team
i think iceland became so strong thanks to the strong	they have a good players
in my opinion it may be that if	i think they are a good team
ronaldo	i think they have been a good player
is the incredible team leader !	he has been a good player
that 's not a question	i think it is a good team
for unk in 2009	i think the best player is the best player
brazil has won the fifa world cup five times	i think they have won the world cup
they are doing well considering that their national league is	i think they are the best player \?
estadio azteca	the best player on the team
i do n't think so	i think that is a good team
no they never have	i think they have won the world cup
what does mexico need to win the next world cup	i think they will be a good team
very good team	i think they have a good team
are unk to list for spain	i think they have a good team
23 players in the spain squad	i think it is a good team
that one guy that score the goals	i think jordi alba is the best player
absolutely it might take a while though	i think that they are the best player \?
yes , cristiano ronaldo is the captain of portugal 	i think he is the captain
who gets the unk unk when ronaldo is done \?	i think the captain is the captain of the captain
varane is the next captain after cristiano and yes ,	i think he will be a good players
professionally in 2002 unk	he has been a good goals
unk caps and 85 goals	he scored the unk
i wish them luck	i think they will be a good team
1930	i think that about the world cup \?
hugo sanchez marquez	i think it is the best player
why are mexico not a more significant force in football	yes , he is the best player \? 
when have they been the top team \?	i think they will be a good team
fc porto is a soccer team that recently competed against	they are a good team
fc porto currently compete in the primeira liga	they have a good team
yes , they are a team to keep an eye	i think they will be a good team
as one of the biggest clubs in portugal , they	i think him
they 're 1st in their league right now	i think they will be a good players
what is their current strip \?	i think they are the best player \?
who is the current manager of fc porto \?	yes , i think that is the best team \?
yes he did	yes , he is a good coach of the best
he was unk at the technical university of lisbon	yes , he was a good team 
he managed real madrid and chelsea he currently manages manchester	i think he is a good player
fc porto has 37 wins , 8 draws and 6	they have a good team
i do not follow the primeira liga but it seems	i think that is a good player on the team
i do n't think the portuguese teams will do that	i think they are a good team
ronaldo is not on his prime anymore and he 's	i think they will be a good team
is he in his all time best shape ever \?	what is the best player \?
are they better than athletico madrid \?	i like them
unk mbappe	i think it is the best player
rm can sign him	i think that it 's a good team
real madrid could sign him to be on their team	i think he needs to be more players to see
juventus probably will be the more dominant team	i think the best player \?
yes , diego costa plays for atletico madrid 	i think that is a good player \?
athletico have a chance but barcelona and real madrid will	yes , i think they will be a good team
i think he 'll stay in the team the manager	unk
about 16 million	the stadium is the best player
unk	unk
teams that win world cups are those can unk mexico	i think they will be a good team
why do you call them unk \?	i think that he is a good team
who is the youngest player in mexico \?	i think they will be a good team
thats not a question , but i'm unk to agree	i think the captain is the best player \?
mexico is playing its very very well games have young	i think that is the best player is the best
luka modric	i think mateo kovacic
es unk su unk croatia	i think they have a good players
unk luka croatia	diego simeone
croatia has never won the world cup , still ,	i think they have won the world cup
yes he is croatia 's best player and their captain	unk is the best player on the moment
i dont	i agree , they are a good team 
it was buffon	i think it is the best player
they lost too many games to qualify	i think they have a good team
if they get their unk together , work on their	i think they will be a good team
there is a unk between coach and players	i think they will be a good team
barcelona will win 5 tournaments	i think they will be a good team
yes thats correct its , la liga 	i think they will be a good team
my favorite team in la liga is barcelona	i like them
they are special because they have many talented members on	they are a good team
they play in camp nou	unk is the captain
sweden was in 3rd place at the world cup 1994	i think that is the best player on the world
he used to , but he 's retired now 	i think he is a good player
zlatan is best player in sweden	i think it is the best player
what do you mean \?	i think they will be the best player
they do it as required	i think that is a good team
debatable , ever since ronaldo 's transfer to serie a	i think they will be a good team
seems like they did do that indeed	i think they have a good team
they have a very good reputation	they are not not not a good team
december 16 , 1899 	the best player was the champions league , but the
ac milan had unk founders	unk
unk the portuguese league !	i think they are the best player \?
solid team play	i think it is a good team
fc porto , team from portugal roma signed spanish defender	i think they are a good team
the new porto 2018 2019 home kit comes with the	white and white
it is pretty expensive	i think that about them
i believe it was carlo ancelotti that won madrid their	i think that is the best team
ancelotti , probably 	what is the coach of the best player on the
he has the right combination of player management skills with	yes , he is the best player \? 
yes it was ancelotti	i think that it is the best player on the
jose mourinho was the real madrid manager before carlo ancelotti	i think it was the best player
yes , they reached the round of 16 at the	i think they are a good team
yes they are good	i think that is a good team
shaqiri	i think it is the best player
best swiss player \?	i think it is the best player
what color is switzerland 's uniforms \?	i think it is a good team
manuel neuer has been with bayern munich since 2011	i think the best player is the best player \?
yes , they are known for their winning 	i think they will be a good team
yes i think bayern may win it this season	i think they will be a good team
red is the color	they play in the team
i do n't see a problem with it	i think they have a good team
i do n't know if the team is really unk	yes , i think that is the best player \?
it fact it 's one of the most unk active	what is the best team
it could help them score more goals , but it	i think they will be a good team
you mean their not there	i think that how many goals is the best player
you have the power of the unk	they are a good team
primeira liga	i think it is a unk
the colors of fc porto are blue and white	they are red
vincent aboubakar is the best of porto	i think it is the best player
he scored 36 goals	he has scored 5 goals
i dont	i like them
unk is a pretty good defender for argentina	i think 13
i love to watch unk	what is the best player \? he is a good
i agree , they could 've gone so much further	i think they are the best player \?
remember when they beat usa 4 1 \?	i think they have a good team
well during the world cup 2 64 goals were scored	i think that is a good player on the world
france scored 4 goals in the world cup	unk
thierry henry has scored 51 goals	i think it is the best player
twice	they have won the world cup
you mean top goal scorers \?	yes , he is the best player \? 
this is unlikely since star players like godin , suarez	i think they will be a good team
well , for example , brazil is typically better than	i think they are a good team
2002	the world cup world cup
they are small country with 3 million population	i think it is a good team
i think it had a great future ! so many	i think they are a good team
no , juventus will win the champions league 	yes , they have a good team 
probably the semi 's	they have a good team
i think the winner will be real but bayern will	i think they will be a good players
friendly v unk on 15th august	the last season
david alaba is one of the defenders	david ospina is the captain
hard to tell he has lots of unk for fc	i think it is a good team
at his age it might be difficult	i think it is a good team
do you think navas has replaced him well at madrid	i think he will be him
what colors unk fc porto 's jerseys \?	i think they will be able to be able to
do they have any sponsors \?	yes , they are the best team \? 
i think so	yes , he is a good player old 
no , he plays for al unk unk 	i think that is the best player on the best
marco verratti replaced him	i think the best player is the best player is
lionel messi	yes , he is a good team 
of course he does	yes , he is a good player 
lionel messi is the best player on argentina	i think it is the best player
i think he is more talented than ronaldo , but	he is a good player to be a good players
who is argentina 's best player of all time \?	i think that is a good team
who is argentina 's coach \?	what is the best player \?
yes scaloni is the boss	yes , he is the captain 
yes	i think they will be a good team
barcelona may be able to cut it in la liga	i think they are a good team
ernesto valverde without a doubt have you seen his stats	i think they will be the best player
i'm not sure but we could unk it given the	i think it is a good team
overall good	i think he is a good team
i think real madrid is the only team competing against	i think they are the best player
they have a new coach but they also sold important	i think they will be a good team
arturo vidal and douglas costa	i think he is a good player
player one the unk who only want to play with	i think he is a good team
i watched their last game , they can do better	i think they will be a good team
i have n't watched the last game	i think they have won the world cup
what about bvb dortmund \?	i think they will be a good team
they have as good a shot as anyone else injuries	i think they will be a good team
borussia dortmund injury unk heading into the international break	i think he has been a good player
you can always look it up ! , who is	what is the best player on the world 's best
mine equal	i think that is the best player \?
they have a strong and proven history	i think they will be a good team
they have 28 major trophies	i think that is a good team of the best
a trophy is not a strength what attributes do the	i think they will be a good team
where is chelsea located \?	yes , i think they will be able to be
chelsea is the best team in london	i think that real madrid is the best team \?
not really !	i think it 's a good team
no but messi is there star player	i think that it 's a good chance to be
to all the bad players out there	i think so they are the best player \?
actually , someone will likely replace messi as an attacking	i think he will be a good team
messi started playing for the argentinian national team in 2005	he has been a good player
brazil are very good , such a fun team 	i think they are the best player \?
very unk , i expected more about brazil 	unk
brazil might have become unk	i think they will be a good team
they will probably do better by next year	i think they will be a good team
if they can find a good big unk forward ,	they will be able to be able to be able
my favourite too	i like them
lionel scaloni is the current coach	i think the captain will be the best player on
very good coach	yes , he is a good team 
if one of his best strikers is messi	i think he is a good team
traditionally their top scorere	i think it is the best player
man u are unk talent right now	i like them
paul pogba is my favorite because he 's very good	i think that is a good team
they have great players starting with pogba	i think he is a good team
no , i think he 's getting tired of some	i think they will be able to be able to
i think they have a good chance but it will	i think it is a good team
many times , they are an elite team 	i think it was a good team
two times	they have won the world cup
angel di maria	i think he is a good player
he is getting old , am not sure about that	i think they will be a good team
yes , i agree there 's a chance 	i think he is a good coach
i think they would beat everyone else , haha 	yes , they have a good team 
yeah i agree	i think they are a good team
i definitely think so	i think they will be a good team
ac milan is worth millions	i think it is a good team
sure they can	i think they have a good team
they have a great history and arguably the best player	i think they are a good team
2015	they won the world cup
there is a good possibility that they will but it	yes , they have a good team 
yes , i'm sure of that 	i think they will be a good team \?
yes , they won last season it was the 3rd	they have a good team
cristiano ronaldo	i think it was the captain of the world cup
cristiano ronaldo was the captain of the 2018 world cup	i think he has been a good player on the
yes he is good	the best player was the best player
he was their man point of attack and i think	i think that he is a good team
i agree that portugal would have gone further if he	i think they will be a good team
very good team	diego simeone
yes and munich unk him	yes , he is the best player on the captain
this is one of my favorite team	i think he is a good team
the best team in the bayern	i think they are playing better than unk
yes , they were the best in the bundesliga during	i think that \?
only if you are argentina !	i do n't think that \?
no , they have similar win unk playing between them	i think they are a good team
croatia is the better team	i think they are a good team
yes they are a better squad usually but i think	i think it is a good team
yes , it was a terrible loss for brazil !	i think they have won the world cup
no , portugal did n't win the world cup ,	i think they will be a good team
yes they won the last unk	they won the world cup
3 1	they have won the world cup
i do n't think they have a chance of winning	i think they will be a good team
i 'd say portugal are within the top 10 of	i think they are a good team
i too am a huge fan of this team	i like them
luis suarez	i think it is the best player
is luis suarez the top goal score for the uruguay	i think it is a good team
who is then \?	i think that is a good team \?
how many assists did he provide this year \?	i think he is a good team
yes , true me too 	i like them
no , i like them for the players they bring	i think they have a good team
well , in addition to their domestic league and cup	they are a good team
there were quite a few but the most expensive was	i think they are a good players
i think so however we wo n't know until the	i think he is a good team
i think the swedish women 's team is more successful	i think it is a good team
i agree that they showed a good amount of success	i think they have a good team
sweden must improve	i think it is a good team
no	i think they have a good team
they are not the best but still pretty good	i think they are a good team
griezmann	i think it is a good player
they have two griezmann and diego costa	unk
i think griezmann	i think they are a good team
jan oblak is one of the keepers for them	diego simeone
he is 26 years old	i think ronaldo is the captain
lukaku , no question 	i think it is the best player
unk van unk unk remains a legend	i think the best player is the captain
tiene un gran unk manchester united	he is the best player \?
gran unk manchester united	i think it is the best player
they win more than lose , but it is not	i think they have a good team
yes most competitive team	i think they are the best player in the world
cristiano ronaldo	the captain is the captain of the captain
did they win last year \?	i think they have won the world cup
they did not win last year	i think they have won the world cup
he scored 41 goals in just 64 appearances	i think they have been a good goals
sometimes these things just happen even great teams can have	i think they will be a good team
sometimes spain will perform to win in the 2022 world	i think they will be a good team
i think their best players are de gea , isco	i think they will be the best player on the
spains best players have to be pique and iniesta	i think they will be a good team
these are their best players cause of their experience	i think it is a good team
do you have a second favourite team \?	i think they are a good team
i do not have a second team , only one	i think that about them
fc porto is ok , but arsenal is the best	i like them
unk points after 23 unk wins	they have won the world cup
senegal was dominate in the regular season	i think they have a good team
not this year	unk
they are 7th in the premier league	they have a good team
it has been unk that they should get rid of	i think they will be able to be able to
in the premier league era , yes , he 's	i think the captain is the best player is the
what league belongs manchester united	yes , he is a good player to be a
berg	unk
he was good enough to be picked for sweden 's	i think he is a good team
it was good enough , but not as good as	i think they have a good team
what colours sweden 's kit	i think he is a good player
who is the coach for sweden \?	they play in the red
why	i think they are the best player \?
i think they are tied	i think they are the best player \?
adenor leonardo unk	unk is the best player
the brazil flag is green , yellow and blue 	the white is red
neymar for sure !	i think the best player \? he is the best
they seem to be very inconsistent , even though they	i like them
i think he is going to retire soon from argentina	i think it 's a good team
i have never unk that game	i think the team is a good player on the
i do n't like any of the players on the	i think it is a good team
they should not make good fire can get higher	i think they will be a good team
unk bale	they have a good team
unk many	unk is the captain of the captain of the captain
yes , they 're one of the most successful clubs	i think that real madrid is the best player on
my favorite player of real madrid is sergio ramos	i like the world cup
gareth bale is my favorite	i think the best player is the best player is
who is their best defender \?	i like them
bale	i think the best player is the captain
sergio ramos is one of the defenses of the world	i think the best player is the captain of the
after unk salah in the champions league final , ramos	i think they are a good team
yes , ronaldo is not that good 	he is a good player , he will be him
they are a solid european side but not the best	i like them
yeah they did	i think they have been a good players
i agree , they are a good team , however	i think they are a good team
what do you think of shaqiri	i think they will be a good team
do you think he will do well in the champs	i think he has been a good coach of the
hahaha ! italy will surprise everyone in the next world	i think they have a good team
i think they are average	i think they are the best player \?
on 6 july 2018 , buffon signed a one year	i think he is a good team
if i am in agreement with you	who is the best player \?
i am not totally sure but i will give it	i think it is a good team
now their best player is cristiano ronaldo	i think he is a good team
what teams has cristiano ronaldo played for \?	i think he is the best player
how much money did he cost juventus \?	what is the best player \?
paulo dybala is a very strong player on juventus he	i think he is a good player
the best player in juventus is ronaldo christian the best	i think he has been a good player
futebol clube	the best player is the best player is the best
portugal !	they are a good team
when did they win \?	i think they have won the world cup
yeah we are the best team	i think they are a good team
yeah ! porto last won in 2004	yes , they have won the world cup 
who is their most expensive player \?	i think that real madrid \?
when did diego costa start playing for atletico madrid \?	i think saul
he signed back there from chelsea last season	how many goals has been a good player on the
he joined in 2014	he has been a good goals
8 32 million unk	the best player is the best player is the best
this is true because argentina are a great team but	i think they have won the world cup
nigeria is a great team too	i think they will be a good chance
the name of the coach is gernot rohr	unk is the captain of the captain
about four years	the best player was the best player on the world
i feel that if they are a bit of a	i think they will be a good players
what is so good about them \?	i think they are a good player on the team
i would have to disagree with that statement paris sg	i think they are a good team
to have an excellent team , he commits some very	i think so they are the best player \?
yes i agree , mbappe will be very good 	i think he needs to be able to be able
he is in his unk	he is a good player on the best player for
they have won it 27 times	they won the world cup
bayern munich is the best team in the bundesliga	i think they have a good team
for me it was lewandowski the best of the bayern	i think they are the best player
they are placed 2nd	the best player is the best player
niko kovac is the current manager	diego simeone
yes because he is getting pretty old now , and	yes , he is a good team 
i'm sure real madrid will unk the money unk on	i think he will be more than unk
anybody can be replaced	i think so they will be him
if i missed him for everything that led me to	yes he is the captain
i think he will do very well	i think he is a good player
no	they have won the world cup
italy won at least 3 matches	i think they have won the world cup
italy never even qualified for the fifa world cup	yes , i think they have a good team 
wikipedia shows their major training ground is in unk	they have a good team
italy wo n't have a worst player , their team	i think it is a good team
yes , they are a strong european side 	i think they are the best player \?
they can win it all	i think they will be a good team
they would definitely be strong contenders with france and england	i think they are a good team
i want belgium to win they got a great team	i think they will be a good team
the best player in belgium is eden hazard	i think they are a good team \?
i dont	i like them
argentina is one of the most popular teams	i think they are a good team
since i have use reason argentina is one of the	what is the best player \?
argentina gave unk in the last world cup	i think it is a good team
88	the most expensive player on the team
their world cup unk was in 1934	the league
i do n't think they were in finals	they have won the world cup
i believe sweden only got the quarterfinals	they have a good team
that is a difficult question for a national team	the unk
they play in yellow and blue	the colors are red
i'm hoping there 's a chance of that	i think they will be a good team
beat them both times they face them	i think they will be a good players
practice twice as much	i think that is a good team is a good
of course and the biggest arena	i think the best player is the best player on
probably because big fans need a big arena	i think that is a good team is a good
sokratis	i think it is the best player
i agree with hummels	i think it is the best player
i am not sure	i think they will be a good team
which club did hummels play before bvb dortmund \?	i think they are a good team
bvb dortmund by far	unk
i was not sure italy had a team before this	i agree , they are a good team 
i think roberto mancini	diego simeone
chiellini	david ospina is the captain of the captain of the
chiellini is a defender	i think he is a good player
not personally , no , but as stated he is	i think the best player is the captain of the
he was a good unk	i think he will be a good players
karius has potential	i think so , they have a good team 
i think that maybe he did unk i did n't	i think he is a good team
i think he has shown that he will get better	i think they will be able to be more than
he wont play now alisson is there	i think he will be able to be more than
they have better players	i think they will be a good team
more unk seems to help the swiss team \( see	the best player is the best player on the world
q1 its is unk place \? a1 yes	i think they will be a good team
what is the furthest that the unk team has ever	i think they are a good team
no , they have n't 	i think they have won the world cup
i'm not really a fan	i like them
the best player of all time has been unk unk	i think the best player is the best player is
they have toni kroos now	i think he is a good player on the coach
the best player currently in real madrid is modric	i think he will be him
yes , they are all time best in their league	i think he is a good team
i think eden hazard is a great forward	i agree , they are a good team 
i'm familiar , i think it 's a good forward	i think it is a good player
yes , he scored 	yes , he was the world cup 
eden hazard	thomas tuchel
de bruyne	thomas tuchel
erik hamren is the coach	the best player is the captain of the captain of
since 2013	he has been a good player
gylfi sigurdsson is their attacking midfielder	he is the captain
hannes halldorsson	thomas tuchel
yeah but we keep unk it and hoping	i think he will be him
unless they traded him and did n't tell anyone then	yes , he is a good player on the captain
they have a lot of other good players it 's	i think they will be able to be able to
real madrid will miss navas ! courtois will struggle with	i think he is a good player on the best
real madrid has some good players	yes , i think they will be a good team
who is the top player today \?	i think that he is a good team
second place	they have won the world cup
they did not score until the 3rd game	who was the world cup \?
switzerland unk for the world cup 11 times	i think they have won the world cup
they did not have to do it better so they	i think they will be a good team
just 2	yes they have won the world cup
chelsea are cool but their owner is a crazy person	i like them
he has let too many good players get away	i think he is a good team
they will get back to being good	i think that he will be a good team
they are indeed so far behind	i think they are a good team
they finished 3rd	they have won the world cup
barcelona has 10 unk	i think it is a good team
yes , this year too 	i think it is a good team
there are 11 players	i think it is a good team
11 unk	i think they have a good team
the vast majority	i think they are a good team
no	i think he is a good player
32	i think they are a good team
germany did not get past the first round this time	i think they have a good team
i ca n't pick a specific one	i think 8 is the best player
i am not sure	i think they have a good team
the last time germany won a game was june unk	they have won the world cup
yes 4 times	i think they have won the world cup
no	i think they will be a good team
who 's the best player in italy \?	i think they are the best player \?
i do n't think he is anymore	i think he is the best player
then he ca n't be that good	i think he is a good team
of course , a good team 	i think they are a good team
that is the problem with the big international competitions they	i think they are the best player \?
he might have unk something bad before playing	i think it is a good team
it could be a more serious injury but without any	i think he is a good player
how long did it take dejan to stop unk \?	i think it is a good team
i would think so they usually have a strong team	i think they will be a good team
i think they could win in the next season because	i think they will be a good team
i agree , belgium will not win the next world	i think they will be a good team
i feel that they must have a better defense	i think they will be a good team
yes , they beat both england and brazil in the	yes , they have won the world cup 
england !	i think they will be a good team
england advanced further than spain in the world cup	i think they will be a good team
most of there team is terrible too many to choose	i think it is a good team
poor coaching and they do n't seem prepared	i think they will be good good
i'm not sure i do n't really follow argentina ,	i think they will be a good team
how many goals did they score in the world cup	i agree , they are a good team 
how many wins did they have \?	he has scored many goals
who do you think was the best player for mexico	they have won the world cup
it seems that javier hernandez was mexico 's best player	the sg is a good team
javier hernandez is their best striker	thomas tuchel
the iceland team is unk this year	i think they have a good team
i do n't think they 'll go far	i think they will be able to see them to
croatia , peru and nigeria beat iceland 	they have won the world cup
peru 3 1 croatia 2 1 nigeria 2 0	they have a good team
what colour is their strip \?	i think they are the best player \?
do you like the unk logo \?	i think that is the best player \?
i really like porto	i think that is a good team of the best
the best of the porto is iker casillas	i think it is the best player
i agree	what is the best player \?
yes , from 2003 2009 	yes , he is a good team 
when was the last time manchester united played the usa	he has scored 22 goals
do you think that they will win against the us	i think they have a good team
they 'll definitely beat any us team	do you think they will be able to be more
do you think manchester united would win against real madrid	i think they will be a good team
higuain	i think they have a good player
he plays striker	he has been a good player
a milan	he is a unk
has messi ever won a world cup \?	i think they will be a good team
do you think argentina will win this year \?	i think they have a good team
yeah , you 're right 	i think them like them
may be	yes , they will be a good team 
individual unk to a group effort that is what makes	do you think the world cup \?
yes , on 7 28 they won 4 1 	i think they have a good team
i think that liverpool will be the better team	i think they will be a good players
i think it 's christian ronaldo	unk
italian league	i think it is a good team
unk , porto , milan etc 	i think they are a good team
he was only signed by them this year hope he	he has been a good player on the world cup
yes he is the best striker	i think that \?
somewhere around 2000 's	they have won the world cup
who 's sweden 's best player	i think they will be a good team \?
what is sweden 's shirt colour \?	i think ludwig augustinsson is the best player
zlatan is the best sweden player	the colors is red
zlatan ibrahimovic is the best swedish player ever	i think ludwig augustinsson is the best player
well played team	i agree , they are a good team 
mbappe and a weak world cup year	i think they did well in the world cup
yes they were favourites to win it	i think they will be a good team
he was amazing !	i think he is a good team
the same as 2018 unless better young ones come about	i think he will be a good players
just fake ones it seems	i think yerry mina is the best player
yeah always unk injuries	i think that was the best player on the world
they are just a team that unk fouls on the	i think he is a good players
yellow cards	i think he scored him
other teams ball	i think he is a good team
it can be unk , but unk team is commonly	i think it is the best player
roman weidenfeller	diego simeone
that is correct , burki is their goalkeeper 	what is the best player \?
yes , he still plays but he is not a	yes , he is the best player 
yeah with unk and unk	he is a good player
based on last season , liverpool finished in a higher	i think they have a good players
i think petr cech , but i'm not sure 	they have a good team
bad	i think it is the best player
they have won more premier league titles than liverpool	i think they will be a good team
lukaku does not play for chelsea he plays for manchester	i think he is a good team
very good team	i think they have a good team
yes , twice in 1978 and in 1986 	i think they have won the world cup
no , there is to much pressure for him 	yes , i think they will be a good team
q what year did argentina win the world cup \?	i think they will be a good team
argentina had unk unk and attacks set up for the	i think it is a good team
thomas lemar was probably the most important to the france	i think it was the best player
believe 12 or 13 squad members were from african countries	i think it was the best player
yes i agree	i think they have won the world cup
i think belgium has quite a unk of african origin	he is a good player on the top scorer on
i do n't think nigeria have much chance , as	i think that is the best player on the world
11 players per team , 22 in total 	the last season
probably last year 's last game	i think it is the best player
i actually never heard of this team before have you	i think it is a good team
gennaro gattuso	gennaro gattuso is the captain
i think he 'll do a good job there gennaro	he is a good team
40	i think he is a good coach
so do i	i like them
9 total	they have won the world cup
it is luka modric	i think it is the best player
i think the rest of the time is fine ,	i think that is a good player on the best
zidane is pretty good to unk	yes , i think they are a good team 
what is so special about milan \?	i like them
ac milan finished 4th in serie a , which is	they won the world cup
is not well they did well last season	i think it is a good team
2010 2011	i think they have a good team
their goalie	i think fabio borini
have n't ever heard of them	i think they are a good team
ronaldo just unk there	i think he is a good player on the best
yes i agree , especially with the recent transfers 	i think they are a good team
will juventus lose any games in the coming season \?	i think he will be a good team
but will they win the champions league \?	i think they will be a good team
4 times	yes , i think they have won the world cup
2014	the world cup
he did in 1996	yes , he is the best player \? 
maybe luis enrique	i think the best player is the captain of the
with their history and unk they are one of the	i think it is a good team
james rodriguez	i think the best player is the best player on
there 's no such thing as a dirty team	i think it is the best player
who is there top scorer of all time \?	i think they are a good team
who is the goal keeper for colombia \?	i think it is the best player
when did ospina join colombia \?	unk is the captain of the captain
have they ever had a black player \?	i think it was the best player
john unk played for liverpool in the late unk and	i think that is a good player on the world
even though q3 unk to liverpool , i do not	i think they will be a good team
maybe he just wants to know the history of black	i think they are a good team
they were originally named everton f c and athletic unk	unk
liverpool was n't first , manchester city was this means	i think that it is a good team
no	i think they are a good team
in my opinion it is the liverpool for having reached	i think they are the best player \?
at the end of the season , the team that	i think it is a good team
jurgen klopp is their manager	the captain is the captain of the captain of the
pele is the best player of all time	i think it is the best player
yes , cristiano ronaldo 's move from real madrid to	i think that it is a good team
if for me it is also the best of all	do you think them
i think it will be affected	what do you think them
real madrid plays unk with their crop of players unk	i think that is a good player is a good
atletico madrid is a newer team , but they have	i like them
it was founded on the 26 april 1903	the other teams in the world cup
diego simeone	diego simeone
angel correa is number 10	unk is the best player
he is the forward	he is a unk
i will like them if they win the national unk	i think they are the best player \?
in 2015	i think they won in the world cup
yes	i think so they are a good team
yes arsenal was strong this year and won their first	i think they have won the world cup
yes they have	yes , they have won the world cup 
i consider them over rated	i like them
i think the chelsea is overrated because the chelsea team	i think they are a good players
how do you think they 'll fair in the epl	i think that is a good team is a good
diego costa	i think the best player is the best player is
antonio conte	the best player is the coach of the best player
so am i they scored a series of surprising wins	yes , i think they will be able to be
totally , could n't agree more 	i think they have a good team
do you think they are better off without zlatan \?	i think they will be a good team
he is a strong act to live up to	i think he is a good team
janne andersson	diego simeone
yes , they even beat the english team in the	yes , they have won the world cup 
iceland was an underdog in the last world cup	i think it is the best player
gylfi sigurdsson kari arnason unk ingi skulason	i think he is a good team
i like sigurdsson	i think ari freyr skulason
they certainly surprised a lot of people the way they	i think he is a good team
i have no unk for them i just know too	i think they are a good team
senegal was founded with the name of sport club juventus	i think they will be a good team
who is the best all time player \?	i think that \?
they are pretty popular but a lot of people do	i think that is a good team
not much i would say	i think they are a good team
who is their current manager \?	i like them
wenger left at the end of the 2017 18 season	i think the best player is the captain of the
no he is not anymore	i think he is a good team
unai emery	i think he is a good team
they are named after the royal arsenal at unk	diego simeone
edinson cavani	unk is the best player
celso unk	diego simeone
i do n't think he did a good job with	i think the captain is the captain of the best
no , they are not at that level this season	i think they will be a good team
me too	i agree , they are a good team 
2nd placed	i think they have won the world cup
thibaut courtois is the belgium goalkeeper	i think the best player is the captain
lukaku scored the most goals for belgium	i think it is a good team
yes , i think they will be able to qualify	i think they have a good team
the best players are ciro immobile , unk unk and	i think it is the best player
about 6 years , i believe 	he has been a good goals
yes i'm very excited about seeing him play	i think he is a good team
how old is ronaldo now \?	i think they will be better than them
it must be good to retire at 34	i think so they will be a good team
yes , i like uruguay 	i think that \?
luis suarez	i think 17 is the best player
they offense is fast acting though	i think that is the best player \?
not as a starter anyways he would be 35 i	i think he will be a good players
maxi gomez is 21 years old	he is a good player on the captain
how much does it cost to see t unk \?	i think they are a good team
unk lions de la teranga \( the lions of teranga	the best team is the best team
yes , they do a great job 	i think they have won the world cup
they need a player like bruno unk , again !	they have a good team
which part of africa are they located in \?	i think that is the best team
a good team indeed	i agree , they are a good team 
zidane played for france	i think it is the best player in the world
what do you think of italy 's uniforms \?	i think he is a good player on the best
how does italy compare to the competition \?	i think they are a good team
yeah spain has no chance	i think they will be a good team
who is their current manager \?	i agree , they are a good team 
if he is the current chelsea coach	yes , he is a good team 
what is italy 's unk staff like now \?	i think he is a good player
yes , all coaches are well paid 	i think they will be able to be able to
unk insigne	i think 89
yes , but i wanted croatia to win because they	i think they have won the world cup
not at all ! france deserved that win for sure	i think they will be a good team
can france win back to back world cups	i think he has been a good players
france has a very effective defense working in their favor	i think they will be a good team
the defense and the goalkeeper are very much unk	i think they will be a good team
estadio do dragao	the best player is the best player is the best
that is f c porto 's stadium , barcelona is	the best team in the team is the best team
yes , their coach was jose mourinho at that time	yes , i think they have won the world cup
i 'd say unk	i think alex telles
he is n't that old	i think the captain is the best player on the
iceland players are very good players	i think they have a good team
they really prove that practice is as important as athletic	the other teams dortmund is a good team
who do you think is their best player \?	i think that is not good team
unk	i think it is the best player
unk unk	diego simeone
yes france won the 2018 world cup	they have won the world cup
paul pogba	i think it is the best player
antoine griezmann	2018
yes in 1998	i think they have won the world cup
16	unk
yes there are unk teams	i think they have a good players
of course a unk has good performance a woman can	i think they are a good team
thats right , the unk team is very good team	i think they are the best player
if you have skills	i think he is a good team
roberto mancini is the current coach of italy	diego simeone
i think balotelli is	i think it is a good team
it is easier to qualify for the european championship than	i think they will be a good team
no	i think they will be a good team
because they suck	i think they will be a good team
they are good , but they are n't that good	do you think they will be a good team
if all teams lose unk	i think they have a good team
there are always losses in games	what is the best team \?
when is it a decline vs just plan unk \?	i think they will be a good team
no it is not a technical term for performance ,	i think they will be a good players
it 's hard to say but my guy says yes	i think he is a good player
i'm sure it 's a lot of time	the best player on the world cup \?
mention the goalkeeper of brazil	i think that how long \?
alisson becker also plays for liverpool	i think it is the best player \?
belgium	i think it is a good team
did iceland place 15th last year overall \?	i think they are a good team
15 reasons why iceland is the most unk country on	i think they have won the world cup
may be	i think they have a good team
it will be but not this year	i think they are a good team \?
it could happen in the year unk	i think they will be a good team
unk	yes , they have a good team 
how many did belgium score this year \?	i think they have been a good team
16 goals that 's good who do you think the	they have won the world cup
i believe the best players are hazard and de bruyne	i think it is the best player
lukaku is the third best player	i think that was the best player \?
what do you like about brazil \?	i think they are the best player \?
i like brazil for its style of play and for	i think they are a good team
i do not agree with this , neymar is a	i think they will be a good team
there are great players on every team	i think them are the best player on them to
yeah it is	i think they are a good team \?
they played the unk unk friendly today	i like them
i am not sure	the most expensive
do you think the other players unk ronaldo 's fame	i think that they are the best player \?
juventus needs ronaldo	i think they will be a good team
ronaldo makes juventus a lot better	i think they will be a good team
how do you think chelsea will do this season \?	i think they have a good team
they will finish 4th it 's all unk	i think that he is a good team
i think chelsea will go far in the europa league	i think he will be a good players
i think chelsea will win the league this year	yes , he is the best player \? 
do you think jorginho will do well in england \?	i think they are the best team
definitely virgil van dijk	i think they are the best player
it is very good , how about chelseas \? 	yes , he is the best player \? 
liverpool is a pretty big team in england	they have a good players
i think they will	i think they will be a good team
they are placed 1st	the best player is the best player
spain have a very good team	i think that is a good team
yes , spain has a very decent football team 	what is the best team \?
i believe it was 17 8	the world cup 2018 world cup
this is a very difficult question but spain is not	i think he is a good team
they 're just not very good	they won the world cup
yes , they have a really good opportunity 	yes , they have a good team 
they are a very good team , but probably only	i think they are the best player on the world
a bayern munich	i think it is a good team
they have won 28 national titles and 18 national cups	they are a good team
the odds against the bayern in the final are high	i think they will be a good team
i'm not sure but is it hernani jorge santos unk	david ospina is the captain of the captain of the
that is correct i agree with it	i think so they are the best player \?
fc porto flag is what color \?	the world cup
f c porto is a club and italy is a	they have a good team
no they did n't	i think they have a good team
why did they not qualify for the world cup \?	i think they are a good team
a team that is being unk needs time	do you think they have a good team
agreed it would be a great struggle but i believe	i think they are a good team
yes i think the rebuilding unk will get better	i think they will be a good team
yes , they have very good team 	i think they will be a good team
who is unk \?	i think that is a good team
salah is a good player , lots of potential 	i think it is the best player
salah , henderson and mane 	jurgen klopp is the captain
not sure , but salah is better 	i think they have a good players
the france national football team represents france in international football	i think they have a good team
i think france will do well they have the aggressive	i think they have a good team
top player for france has to be kylian unk	i think it is the best player
yes , it 's not looking good for france i	i think they have a good team
so am i	i think they will be a good team
i am a bot , ca n't see matches 	yes , i think that is a good team 
he is a very valuable player	i think they will be able to be able to
chelsea fans are quite unk when they are in their	i think that it is a good team
palace fans are definitely way better than chelsea because they	i think he is a good team
they got some unk fans	yes , i think they have a good team 
a bit unk	i think they will be a good team
at the moment it has been formed much better	the best player was the best in the world cup
did you watch their last match \?	i think they will be better than them
guardado is a very good player	i think that is a good players
who do you think that he is a bad player	i think he is a good player
i did not see the game	i think they have a good team
no , you do have to respect their talent 	i think they are a good players
never been a fan of liverpool do n't like their	i think they are a good team
klopp 's one of the most interesting managers in the	yes , i think that is the best player on
yes futbol	i think they have a good team
i think liverpool 's main rivals will be manchester united	i think they will be a good players
if klopp unk his previous trend , he should win	i think they have won the world cup
klopp is under a lot of pressure	i think they will be a good team
i agree , and if salah and mane continue their	i think he is a good player
when did they start \?	modric has been a good players
i think it will be klopp 's last chance	unk
of course , they have one of the best players	i think they will be a good team
just not good enough to progress far in the world	i think they are the best team \?
do you think your team is the toughest among all	i think they will be a good team
what he was improve \?	i think they have won the world cup
no , but they won the european championship in 2016	i think they have won the world cup
i think unk is	i think the best player is the best player is
are you high \?	i think that he is a good team
messi is argentinian , not italian ! 	i think neymar will be him
they will definitely qualify last time was just a unk	i think they will be a good team
unk unk is the current coach	diego simeone is the captain of the captain of the
yes , in 2017 2018 	yes , they have a good team 
i do because they unk each other	i think white and white
marco reus	i think paco alcacer is the best player
the exact number is not available , but i would	he is a good players
lucien favre , i quite like him 	i think it is the coach of the best player
schalke bayern and unk are three of their biggest rivals	i think they have a good team
it is marcus reus	i think it is the best player
bayern munich for sure	i think that he is a good team
probably a few	i think it is a good team
unk is not a question so i ca n't answer	i think they are the best team
yes iceland did well that day	do you think they have a good team
iceland should train their offensive players to attack more and	i think they will be a good team
gylfi unk is in my opinion	i think the best player is the best player
hannes unk	i think the best player is the best player
even with the injuries to neymar last season psg were	i think they are a good team
yes , it 's bad for one team to rely	i think they are a good team
kylian unk , the young star from the french world	i think he will be a good players
i think stanley unk shows real potential	i think that it is a good players
i disagree i think paris sg can afford unk	i think it is a good team
probably harry unk after his performance at the world cup	i think they will be able to be able to
i have no idea what that means	he is a good team
mexico	i think they will be a good team
in my opinion no ! there are many dangerous areas	i think they will be a good players
too long , think it should be a unk unk	i think that is the best team \?
unk unk is the coach	i think the captain is the captain of the captain
i think they 'll do great actually	i think they will be a good team
they went 18 10 10 last season	they won the world cup
the first one for unk	the most expensive player on the world cup
a little while back	i think france has won the world cup
i think so ! should be alot better	i think they are the best player \?
i think they will unk from the top unk level	i think they are the best player \?
i do not expect them to do much in their	i think he is a good team
yea spain will do fine	i think that is a good team
for me isco is the best in spain at this	i think that it is a good team
he has held a record and wants to be have	he has been a good player , he will be
argentina can give them a run for their money	i agree , they are a good team 
i think that brazil are better	i think they are a good team
would brazil play better without neymar \?	i think they are a good team
neymar traditionally	i think 2 is the best player
no , neymar is first not second place 	i think they have a good team
they have won twice	they won the world cup
they won it in 1984 and 2000	they won the world cup
only the two but they have come close several times	i think they have won the world cup
no tienen unk unk france	i think the best player on the champions league \?
yes , they have some good unk up front 	i do n't think they have a good team
i think liverpool have a lot more potential going in	i think they are a good players
liverpool has become an excellent team these last years	i think they will be a good team
liverpool was at the final of the last champions league	i think they have a good team
no way man !	i think he is a good team
yeah , ronaldo was unk up the whole cl ,	i think they are a good team
my favorite player is their starting striker	i think juan mata is the best player
alexis sanchez , did n't like the way he left	i think that is the best player is the best
he wanted to play for jose mourinho	he is a good player
he is a good striker	i think he is a good team
james unk is the most talented because of the amazing	i think they will be a good team
yes very talented but ok you do the same	what is the best team \?
yes , cristiano just transferred to juventus 	i think he is a good team
if that is a question , yes he will e	i think he will be him
definitely , they have been close a few times recently	i think that is a good team is a good
it depends one player alone does not make a whole	i think they have a good team
one of the best players in the world he better	i think that is a good team is a good
no the most expensive player neymar plays for psg	i think it is a good team
they are trying to get eden hazard	i think they will be a good players
i think that any idea i have is a good	i think them have a good player \?
real madrid flag is what color \?	i think the best player is the captain of the
more than other teams	i think they will be able to be more than
yes	i think they have a good team
they always finish fourth	i think that is a good team
what stadium does arsenal play in \?	i think they will be a good team
sport unk	i think they will be a good team
i think he would face liverpool	i think they will be a good players
andres unk unk	i think that it 's a lot of money
i believe they received unk	i think he is a good team
he scored an own goal	he is a good player
really feeling sad just to know this	yes , he is a good team 
may be arsenal win premier league in 2018 19 \?	i think they have a good team
yes who is your fav player \?	i think they are a good team
i do n't like any of there players	i think it is the best player
no i am not a against arsenal because am arsenal	i think they have a good team
arsenal is a great player , who would n't love	i think they have a good team
i do n't understand people that hate them have a	what is the best player \?
roman abramovich	unk
did roman abramovich play for chelsea at one point \?	i think they will be a good team
no , roman abramovich is a unk and he has	i think they are a good team
chelsea won 3 0 on saturday	i think that he is a good team
not really , no , they fell behind last season	i think that is the best player on the world
10 years ago	he has been a good goals
valverde	the captain is the captain of the captain of the
in my opinion , not very well 	i think that it is a good team
yes , they are one of the top teams 	i think they are a good team
with the squad they currently have they have every chance	yes , they will be a good team 
me too	i think they are a good player on the team
i heard neymar spent almost 5 minutes during a game	i think they will be a good team
paris saint germain defender presnel kimpembe , a member of	i think he has a good team
always the titles of france just want to win the	they have won the world cup
neymar joined psg in 2017	unk
they have not played a game in the premier league	i think that is a good team
chelsea signed jorginho from napoli	i think that it is a good team
he 'll be very unk in midfield	i think he will be able to be able to
mention 3 best players of chelsea	do you think modric is the best player \?
i think eden hazard is the best one , no	i think he is a good player on the best
not very good after getting knocked out of the 2018	i think they are a good team
i think he will retire from international play by 2022	i think they will be a good players
i think 2018 was his last chance to win the	i think they will be able to see them to
argentina will always be winners	i think they will be a good team
for 2022 they will need an overhaul messi is done	i think they will be a good team
what was their most unk defeat \?	i like them
will lionel messi win a world cup with argentina	i think they have won the world cup
what colour is argentina 's kit	i think that he is a good team
messi is on the ball right now	i think it is the best player
their starting goalkeeper did get injured right before the last	yes , i think that he is a good team
yes , juventus acquired an amazing player this year by	i think it is the best player \?
yeah ronaldo will do great things for juventus	i think he is a good player
yes , he 's one of the best players in	yes , they will be a good team 
i agree ! i see juventus winning the champions league	i think that it is a good team
the youth has very good players , but now cristiano	i think so they will be a good team
i think the same a penalty but we will see	they have won the world cup
its manuel neuer the germany goalie	david ospina
marius wold unk	i think 8 is the best player
yes it was sad	i think he is a good team
yes , they won several world cups 	i think they are a good team
croatia has modric one of the best players in the	i think they will be a good team
now at days they are the number 4 at fifa	they have a good team
higher	they play in the world cup in the world cup
currently it 's ivan perisic	the best player is the best player is the best
he is 29 years old	i think the captain is the captain of the captain
they have plenty of players	i think they have a good team
they have one british player , jadon sancho 	i think they have a good players
raphael unk jose guerreiro is portugese	i think that is a good player on the best
no i personally dont think he is	i think that is the best player on the best
by far , christian pulisic 	i think paco alcacer is the best player
i dont	i like them
they are not very structured	i think they are a good team
i think they have one of the best teams in	i think they 're a good team
i hate nigeria team because they are so unk	i think they have a good team
they just do n't want it enough !	i think they are a good players
they could have done better this world cup but they	i think they are a good team
better luck next time	i think they will be a good team
no , brazil is a better team than argentina 	i think they are a good team
because they have consistently played better	i think they are a good team
messi is better	i think they will be a good players
liverpool are a good team but i do not like	i think they are a good players
have you ever been to a liverpool home game \?	i think they are a good team
what do you think about the liverpool fans \?	i think they have to win
have you experienced it \?	i think that is a good team is a good
absolutely they can , yes 	i think they have a good team
very good team	yes , it is a team 
yes they have very good players \( modric , rakitic	i think they have a good team \?
if they can keep the momentum going	i think they will be a good team
alen halilovic	i think they will be a good team
yes i think they will , they have the potential	i think they will be a good team
maradona ! best footballers ever	i think they are a good team
yes , messi is their best player 	i think they will be a good team
i do not think so , he always has something	i think they will be a good team
is he your favorite player \?	yes , i think they are the best player \?
argentina is one of the most successful national soccer \(	i think that is a good team
brazil is my favorite team because they have some great	i agree , they are a good team 
how good is brazil \?	i like them
what will happen to brazil when all of their high	i think they are a good team
brazil has always had excellent players , unk one 	yes , i think so 
their last time was 2002	i think they have won the world cup
i think belgium need to do more to be successful	i think they are a good team
i think the need to play a more structured european	i think they will be able to be able to
eden hazard	i think it was the best player
yes he is a unk 's best player \?	i think it is the best player
romelu unk belguim is the man	i think he is a good player
very good team	i think that was founded \?
i think el unk unk unk scored	i think they have a good team
slightly better than this year	i think they will be a good team
what better expectations does croatia have \?	i think they will be a good team
probably not they were n't in the top 10 last	i think they will be a good team
mexico is an ok team if you like their playing	i agree , they are a good team 
they play well i like when they unk the ball	they play in the world cup
el unk unk their place at next summer 's world	i think 15 is the best player
yes , if you like their mediocre offense 	i think they are the best player \?
hirving lozano	i think it is the best player
italian club team ac milan plays in the serie a	i think it is a team
ac milan recently played against manchester united	they are a good team
ac milan tied man u 1 1	yes , they have won the world cup 
what 's ac milan 's ground called	i think they are the best player on the world
is ac milan a good team \?	i think it is the best player
i think bvb dortmund will turn things around	i think they will be better than them
bvb needs to let less goals in and score more	i think they will be able to be able to
how did bvb do in their match against benfica \?	i think they have been a good players
yes , i believe that he is the best in	i think he is a good team
yes , and he is also the captain of the	i think he is a good player
no specific founder , like most spanish clubs they were	the best player is the best player is the best
unk	unk
luis aragones	i think saul is the best player
i think he 's one of their best	i think it is the best player
red white and blue	white and white
the atletico de madrid	i think they have a good team
every 7 years or so	unk
i have to look up	i think they have a good team
difficult to say actually	i think they will be a good team
i think unk griezmann , from atletico madrid 	they have a good players
i like iker casillas	i think they are a good team
where are they from \?	i like them
i am not familiar with fc porto	i think so he is a good team
what caused the fight \?	yes , i think that it is a good team
no i ca n't unk that	i think so
unk what about fc porto next season \? unk not	i think he has been a good players
good team	i think they have a good team
i think portugal has the better players but mexico works	i think they are a good team
i think that portugal would win unk	i think they will be able to be able to
yeah , he 's their top scorer and captain 	i think they will be a good team
would they be significantly unk without him though \?	i think they are a good team
very good team	i think the best player on the world cup \?
but not good enough to compete with bayern	i think they are the best team \?
yes , bayern are very strong though 	i think they will be a good players
they will win in future	i think that it is a good team
maybe favre	i think so they will be a good team
if it is i like how he unk his players	yes , he is a good team 
i think you can unk to champions	i think they will be a good team
tony adams	i think alexandre lacazette is the best player
i have no idea	i think it is a good team
yes i think he is leave before the transfer window	yes , i think they will be a good team
2006	they won the world cup
4	i think they have won the world cup
i do not think it 's possible	i think they will be a good team
if you fight to achieve it you can win	i think that about chelsea
italy has a chance but it will take a lot	i think they will be a good team
james is probably the best from colombia	i think it is the best player
no columbia is not a good team	i think they are a good team
they did okay	they have a good team
yes columbia does	i think they are a good team
yes they have the talent to do so	i think they will be a good team
very good team	i think they will be a good team
yes , here 's the reason they did n't qualify	i think that is the best player on the team
is 4 times world champion if good players can be	i think they will be able to be able to
they should they have unk footwork	i think that is the best player \?
they will have to work on improving to qualify	i think they will be able to be more than
real madrid	they have won the world cup
barcelona can for sure beat real madrid	i think they will be a good team
messi	i think it is the best player
i think he 's a decent player , but has	he is a good team
ramos and marcelo are older but still world class varane	i think they will be a good team
they are not the best team in africa but they	i think they are a good team
it will be hard but not impossible	i think that is the best player on the world
senegal does not stand a chance against them	i think they will be a good team
senegal has won before	i think they have won the world cup
cheikhou kouyate	david unk
radamel falcao is the captain of colombia	i think the best player is the best player is
if he is a good player , he had an	i think he is a good player
will rise from 16th place colombia \?	they have a good team
they are always competitive so yeah !	i think they will be a good team
arsenal when they travel down south	they are the best player
very good team	i think that they are a good team
but they have unk away a bit recently	i think they will be a good team \?
they will came back again \?	i think they will be a good team
this is absolutely one of my favorite team	i think they will be a good team
unk current roster with the right formations and tactics	i think they will be a good players
i unk like pepe on their team	i agree , they are a good team 
if he plays very rough	he is a good team
he is the best in the world , i like	i think it 's a good player to be him
cristiano ronaldo	i think ruben dias
i think messi is the best player	i think he is a good player
i am all for bayern munich !	i think the best player is the best team in
unk	the captain is the captain of the captain of the
have more wins and bring more trophies home	the captain is the captain of the team is the
peter unk scored the winner vs bayern munich	i think they have a good team
is n't the central midfielder this year javi martinez \?	i think that they will be a good team
one of the world 's best	i think they are a good team \?
they have some of the best players in the world	i think they have a good team
france vs brazil would be a good match but not	what is the best team \?
france would unk germany at the moment as france is	i think they have a good team
spain	i think they have a good team
he plays for real madrid and spain	unk
unk , mariano diaz unk is playing on real madrid	i think that real madrid is the best player \?
tomorrow !	the most club is not think it is a good
against unk	i think the team is a good team
jesus vallejo	i think they will be a good team
at the moment , ahmed mousa 	i think it is the best player
yes , one of his position 's is forward 	thomas tuchel is the captain
who is the most underrated player for nigeria \?	i think it is a good player
have nigeria ever won the world cup \?	i think that it is a good team
nigeria still has to win	i think they have won the world cup
arsenal did not play in the world cup	they have won the world cup
i think it was olivier giroud	i think he has been a good player
lacazette was last seasons top scorer with 14 goals all	what was the last world cup they have a good
i do n't think so there are betters manager than	yes , i think they will be a good team
salah would be a great striker to play for arsenal	i think it is a good team
no , i think spanish football is technical and exciting	i think they will be a good team
i agree , spain football is exciting 	i think that is a good player is a good
spain has great possession tactics	i think they are a good team
do you think they lost the world cup because they	i think he will be him
it unk out of a different environment into something unique	i think they are a good team
italy are in a re unk phase	i agree , they are a good team 
unk always unk the way to go to the world	i think they will be able to be more than
currently the italy goalkeeper is buffon	david ospina is the captain
i think they are unk unk when it comes to	i think he is a good team
did you know who is the goalkeeper of italy \?	i think that is the best player \?
probably going to lose a lot more	yes , i think they will be a good player
my favorite is modric he 's one of the world	i think the best player is the best player
it is a club , besides , it is the	yes , he will be a good players 
he will be missed but it is a team sport	i think he will be more players
he is unk	i think he will be him
diego simeone is atletico madrid 's current manager	unk
is it common for managers to have been players \?	i think the best player on the world cup for
but it is less common for them to play and	i think he is a good player
atletico madrid typically wears a red and white striped shirt	white
their secondary kit is light blue shirts with unk blue	yes , i think that black and white 
probably not he has a history of injury	i think so , he will be a good team
of course they will	i think they will be a good team
10 2 \? or am i thinking of 2016 \?	i think it is a good team
in the last season they reached the final of the	i think they have won the world cup
i think it 's jurgen klopp , 	diego simeone
france may have had a fair share of luck but	i think they have a good team
is france 's biggest rival liverpool \?	i think he is a good player
mbappe	i think 15 is the best player
how many teams are unk france top league \?	i think he is a good team
blue , white and red 	white and white
i dont	i agree , they are a good team 
italy last won the world cup in 2006	they won the world cup
i absolutely adore italy	i think that it is a good team
there 's definitely a chance , but we 'll have	i think they will be a good team
they dont have a good player	i think the best player is the best player on
they 're all great it 's hard to choose !	i think it is the best player
lovre kalinic is my favorite keeper	i think he will be a good team
why is that \?	i think it is a good player
true , he 's a good guy and solid player	i think that he is a good player
mario has dominated yeah	i think he is a good player
who is your favorite player \?	i think they are a good team
i also like that team but my favorite player is	i think it is the best player
isco	i think jordi alba is the best player
again , isco for sure ! 	i think the best player is the best player is
who said they are getting a new manager	i think it is a good team
unk was really helpful to settle unk	i think they will be a good team
sweden unk from it not being used correctly	they have won the world cup
we 're are sweden ranked	i think they have a good team
sweden has a great front	i think he is a good player
sweden must work to achieve it	i think they will be a good team
1960	founded in the world cup in the world cup in
they are a very strong team	i think they have a good team
what was nigeria 's record last season \?	i think they have a good team
nigeria has a decent record	they won the world cup
they are unk up the ranks	i think they will be a good team
what are their best attributes \?	i like them
the best attributes is when the team wins	i think the best player is the best player is
portuguese superliga	they have a good team
yes they are	i think that \?
yes they do sure !	i think it is a good team
turin , 1897 	he is a good player
turin , italy is the answer 120 years is the	i think that \?
no there are some clubs founded in the unk 's	i think that was founded in the world cup
they have at least more wins than losses	they have a good team
i was not able to find it but i did	they have a good team
they only have one	they have a good team
i am not sure , about the same numbers as	they have a good team
uruguay team have a lot of players , but only	i think that it is a good team
is unk uruguay 's best team \?	he scored the unk
if the best	i think that is the best player \?
4	i think they have won the world cup
they won in 2014 in brazil	they won the world cup
klose	they are a good team
i think it needs time and a new coach	i think they will be a good team
he is very unk	i think the captain is the best player on the
i like bayern munich , they are the best from	i like them
it was founded on february 27 , 1900 	the best player was the best scorer in the world
almost every team in europe has a womens team	i think that is a good team is a good
unk probably	i think they have a good team
many people like them	i like them
lionel messi	i think arthur
7	i think they have been a good goals
no player is compared to maradona	i think the best player is the best player is
mention the best player of barcelona	i think so i think so
hopefully they are not too wore out to play	i think they are a good team
red and white	they play in the world cup
if they have been white and red for a long	i think that porto is a team and white
ronaldo luis unk de unk unk known as ronaldo el	unk is the best player
unk unk may be their best striker historically	i think they are the best player \?
aron gunnarsson	diego simeone
the largest stadium in iceland is unk that has a	unk
there are a few , they all played well this	i think ari freyr skulason is the best player
iceland will dominate all next year !	i think they will be a good team
i think he plays uefa	i think they have a good players
they lost to colombia last time	i think they will be a good team
morocco is listed higher by fifa	i think that is the best player on the team
do they have what it takes to get out of	i think they will be a good team
all of the teams in this area are excellent	what is the best player \?
yes it is best african team	i think they will be a good team
for sure they will be !	i think they will be a good players
who is paris sg 's unk competition \?	i think they will be a good team \?
yes easily , expect it to be at least 5	i think that is a good team
the best player in psg is neymar jr	i think it is the best player
yes you are right to win you need a good	i think the next world cup
i believe most of them do in the off season	i think they are the best team
they have messi	they are a good team
yes it is	yes , he is a good team 
a lot of money	the next world cup
they are very very rich	i think they are a good players
no , i think it 'll be croatia 	i think they will be a good team
spain will come back full force next time	i think they will be a good players
what are spain 's colours \?	i think they will be a good team
spain won its only fifa world cup in 2010	they have won the world cup
if spain has a good team but they do not	i think they will be a good team
i am not such a fan of arsenal but i	i think they are the best player \?
they 've been average in past few seasons	i think they are a good team
arsenal is a great team from spain	i think that how long of course i think their
london is a beautiful city	i think that real madrid is the best team \?
una is their boss	unk is the captain
yes , as they won the final last time 	i think they will be a good team
it is possible that france will win the next world	i think they will be a good team
yes , i think it will be still the same	i think that is a good player is a good
france is definitely the best	i think they will be a good team
france has a lot of future with mbappe	i think so
bayern did amazing	they have won the world cup
robert lewandowski	i think it is the best player
no he is not dumb , i like him !	i think he is the best player
i do n't know , i always thought he was	he 's a great team 's a good player to
i still think bayern munich will win the title this	i think they will be a good team
they 're a small country but a good team	i think they are a good team
excellent team to watch play	i think they will be a good players
maybe not yet , they should train 	i think they have a good team
of course they unk	they have a good team
hannes thor halldorsson	i think he is a good player
yes i do	i think they will be a good team
yup , they won the world cup in 2018 	i think they have a good team
that is too far away to predict many things could	i think they will be a good team
if i think i win more world	i think they will be a good team
by the hand of mbappe and paul pogba	i think they will be a good team
do n't you think they are a bit over rated	i like them
what has the nfl got to do with football \?	i think so they will be a good team
i think that although they are both soccer , they	i think that is a good team is a good
red , blue and white 	they play in red
hes name is estadio metropolitano	the stadium is the captain
they play in westfalenstadion stadium in germany	unk
who is dortmund 's head coach \?	i think that porto is the best player on the
unk it up and see	unk
son unk bvb dortmund	what is a good team \?
dortmund , is a german sports club based in dortmund	i think that is the best player \?
definitely	i think they have a good team
2011	i think they won the world cup
ac milan beat unk in 2011 italian championship	they have won the world cup
forbes has ac milan 's net worth listed at unk	unk
they will bounce back for sure	i think that is the best player on the best
mexico used a 4 3 3 formation most often ,	i think it is a good team
i think it was more to do with a lack	i think they have a good team
with a little more work then anything is possible	i think they will be a good team
mexico needs unk gomez back	yes , he is a good team 
they would change to chicharito	i think 15 is the captain
juventus was good before but now that they added cristiano	i think they are a good team
in this season currently in 2018	i think they have a good players
they have a great team , the possibility is high	i think they will be a good team
if i think they win the trophies	yes , he is a good player 
only if unk does n't show up	i think they have won the world cup
i think finishing in round of 16 was expected	i think they will be a good team
no they are very average and were expected to get	i think they will be a good team
not really if you consider germany 's performance	i think they are a good team
andres guardado \( captain \)	diego simeone is the captain
since 2012	he has been a good player on the captain
lionel messi is argentina 's top goal scorer	unk
in argentina and in barcelona too	i think they will be a good team
franco armani	i think 13
he is not the best goalkeeper	yes , he is the best player \? 
he only just unk his international career this world cup	he has been a good player
no , he will not 	i think he will be a good players
i do n't think it will make much difference	he is a good player
he is given rest to come back well	i think he will be him
i think he will score many assists	yes , he is a good team 
they are 5th	they have a good team
i dont	i agree , they are a good team 
cristiano ronaldo	i think it is the best player
it 's rui pedro dos santos patricio	i think he is the captain
yes	i think they have a good team
yes , it was very boring to watch them play	i think they will be them
the score was porto 3 1 aves	i think its unk
yes , porto is the best team in portugal 	i think they will be a good team
yes , correct if you keep winning 	i think they will be a good team
conceicao is the coach	i think the captain is the captain of the captain
ronaldo for sure	i think alex telles is the best player
yes , they beat aves by the score of 3	i think it is a good team
it is a team unk in the primeira liga and	the most expensive player on the world cup
yes , i think porto has better team unk 	i think they are a good team
no , manchester united is a stronger team 	i think they are a good team
their next game will be 08 19 2018	i think it is a team
i think it was a good thing for them	i think they will be a good players
absolutely unk klopp is an excellent leader and salah is	yes , they will be a good team 
if he stays in liverpool , then yes 	i think he will be him
i do ! they have many good players	i think they will be a good team
yes they focus very much	i think they have a good team
do you watch them on tv \?	i like them
when it was the last game of nigeria that you	i think it is a good team
nigeria is my favorite team	i think they will win the world cup \?
better than cameroon \?	i think they are the best player \?
celebrating cameroon through unk	i think they will be a good team
senegal are great , the lions of teranga ! 	i think they are a good team
yes they are very unk , big and strong 	i think that it is a good team
who is the oldest team member on the senegal team	i think they will be a good team
he was a defender , but is currently retired 	he is a good player
unk unk unk unk	i think they are the best player
does real madrid have the most expensive player \?	i think that is the best player on the world
no it does not have any expensive player	i think o46 is the best player
no there are plenty of good players with lots of	i think that is a good player \?
i think that is sergio ramos , or unk 	i think their current coach is the best player on
i think i would sign kroos he is very unk	i think that it is a good team
their nickname is the red unk	i think they are a good team
2nd	they have a good team
manchester city or liverpool this season	i think that if they will be a good team
manchester united might win	i think they will be a good team
it was more than just one player the team effort	n't do n't think it is a good player
probably unk unk , but i'm not sure 	the best player was the best player in the world
who is your favorite player \?	i think that is a good players
my favorite player is unk and the player with the	i think they are a good team
i agree that it will	i think they will be a good team
unk is unk the worst player and i do n't	i like them
brazil is always a powerful team who is your favorite	i think they are a good team
neymar is good , he has been compared to pele	i think they are a good team
if neymar is good	i think they have a good team
who is the best manager brazil has had \?	i think so he is a good team
what are the team 's colours \?	i think it is the best player
many would say unk unk	i think it is the best player
goalkeeper is definitely an important position , but , unk	i think it is the best player
not this year	i think so , i think so 
manchester 's colors are red and yellow	white and white
fred , paul pogba , alexis sanchez 	i think the best player is the captain
quarter finals in a world cup	i think that about the world cup
2002	i think it was the world cup
nope , nigeria has been unk senegal in the african	i think they have won the world cup
i think senegal wins the next african cup	i think they will be a good team
when was the last important game that senegal won \?	the unk
when the club was founded , their motto was unk	i think that modric will be playing in the world
lukaku for sure	i think it is the best player
what makes lukaku so great \?	i think he is the best player
lukaku is great for manchester united because he is strong	i think he is a good team
excellent is the word unk	i think they will be a good team
they 're not bad watch unk	i think that is a good team
yes , they will get old and slow so their	i think they will be a good players
yes i think they will cristiano ronaldo is not getting	i think they will be more players to see them
fernando santos	diego simeone
pele 1 , unk goals 	unk is the captain
spain need to get their act together	i think they are a good team
improving the counter attack and firing more to the area	i think that it is a good team
no spain needs more unk between the coach and the	i think they will be a good chance
i do not believe the current coach has what it	i think that it is a good coach of the
luis enrique	i think they will be a good team
how the unk like bayern munich \?	i agree with them
i like lewandowski because he scores lots of goals	i like them
it 's nice to see bayern munich , but i	i think that it is a good team
for sure , unk have some competition from bvb but	i think they will be a good team
it is always difficult to lose to a rival ,	i think they will be a good team
gareth bale	i think the best player is the best player for
marcelo	i think he is the captain of the captain of
he unk more for the team	i think he is a good player on the next
i agree	i think he is a good team
i think so	i think the best player is the best player on
eventually	i think they will be a good team
no they reached the semis in 1966 and 2006	yes , i think they will be a good team
what does the end of the euro have to do	i think they will be a good team
they need better youth players	i think they will be a good team
not that i'm aware of any	i think he will be able to be able to
yes , he is 	i think that porto is a good team and white
i would argue that unk they 're traditional means they	i think they will be a good team
yes they have a history of success	i think they will be a good team
i hear there favourite record is by a famous unk	they have a good team
lucien favre	i think it is the best player
yes finishing third was extremely unk and they had some	i think they have a good team
i think it was 25	i think it was the world cup
thomas vermaelen	i think it is the best player in the world
yes i think so	i think thomas meunier is the best player
belgium is the actual team and not a player	i think they are the best player \?
five	they won the world cup
more than 50	yes , they have a good team 
possibly , due to mohamed salah 's fantastic form recently	i think that he is a good team
is salah a good header \?	yes , he was a good player on the world
liverpool has a great header	i think he will be him
wikipedia shows that eidur gudjohnsen is the iceland top goalscorer	unk
probably gudjohnsen	i think ari freyr skulason
i hope so	i think that in the world cup
lionel messi is the best	i think it is the best player
i think he will keep playing at least for another	i think he will be him
they will probably use him more	i think he will be more players to see them
messi	i think it is the best player
they are definitely an active team	he is a good player
of all time \? david villa	david ospina
worst jordi alba \( spain \) was unk	i think it is a good team
he is alright	i think it is a good team
uruguay is okay but none of the players stand out	i like them
uruguay is a good team that could have done more	i like them
yes , if it is available to win the world	i think they will be a good team
i wonder how he is too since he 's in	i think they have a good team
oscar tabarez is their manager	diego simeone
i think more than 10	i think they have won the world cup
last in 1986	they have won the world cup
sergio romero	david ospina
sergio romero is also the captain	i think the captain is the captain
me too	i think they are a good team
no , they will not win the league 	i think they will be a good team
they have a possibility of winning the league	i think they will be a good team
2	i think they have been a good goals
liverpool unk 8 players recently	i think they will be a good team
i think it 's ronaldo	i think he is a good team
a year ago	i think it is a good team
nani unk a good player	how many times has many times won the world cup
ronaldo	i think ruben dias is the best player
because of his unk , and how long he has	i think he is the best player
the next game is on august 19 2018	i think it is a good team
i think they will tie	they have a good team
i think they will make a good game	i think they will be a good team
seven goals in one match is a big unk	i think that is a good team
milan is the best team in the italian league	i think that is a good team
no , i was n't because they are a very	yes , they have won the world cup 
that would be thomas jefferson	i think it is the best player
sadio mane	i think that is a good team \?
they play in green and white very stylish \)	yes , i think they are red 
they dont have one	i think it is a good team
in total 25	i think they have been a good goals
yes , he is one of the famous player at	i think they are a good team
yes , he does 	i think he is the best player on the best
i do believe the defence from real madrid is one	yes , he is the best player on the captain
i think karim benzema	unk
yeah , switzerland is awesome , especially with all their	i like them
he was traded to liverpool but he was a star	i think the best player is the best player is
i think that they do not play well enough at	i think they will be a good team
they can win every team is able to win wc	i think they will be a good team
shaqiri may be their best player	i think it is the best player
i also like argentina	i like them
yeah they are good	i like them
white and light blue are the colors of argentina	white and white
he is still going strong , i hope so 	i think that i think that is a good player
it sounds like a good way to spend a day	i think it is a good player on the team
no i do n't	i think he is a good player
yes they 're definitely a better team than the u	i think they have a good team
belgium has strong unk such as its stars eden hazard	i think they will be a good team
belgiums stars are in their unk	he is a good coach
what is not to like about them \?	i like them
when they unk a strong unk	i think the best player is the best player is
real madrid is my favorite team , they 're the	i think that is a good team
why does real madrid unk that huge amount of money	yes , i think that is a good team 
what 's the unk unk of real madrid \?	i think so , they have a good team 